5 5 1
x x x x x
 x a b b x
x a a x x x
 x . . . x
x x x x x